...........................#########.......................................................................................................
...........................#.......#.......................................................................................................
.......#####################.......#######################################################################################.................
.......#...........................#.....................................................................................##................
.......#.....###............########......................................................................................##...............
.......#.....###............#...........................................#######################............................##..............
########.....###............#################..................................#..............##............................##.............
#...........................................##.......##...................####..#..............################################............
#.#########################################..##.....##...................#....#..#............................................##...........
#.#...........................................##...##...................#.....#...#.......................###################..##..........
#.#.############################################..##....................#.#...#..#.......................##.................##..##.........
#.#.##########################################...##.....................#..##...#.......................##...................##..##........
#.#.............................................##.....................###.....#.......................##........######.......##..##.......
#.###############################################.....................##..######......................##........##.....##......##..##......
#..........#.........................................................##..............................##........##.......##......##..##.....
##########.##.....################################..................##..............................##........##.................##..##....
.........##.##....#...............#..............#........###########..........................##..##..........#####..............##..##...
..........##.##...#..............#...............#........###########.........................##..##...............#...............##..##..
...........##.##..#.............#................#........###########........................##..##.................................##..##.
............##.##.#............#.................#........###########.......................##..####.#.##.#.##.#.##.#.##.#.##.#.##.#.##..##
.............#.#..#...........#..................#........###########......................##..##..#.##.#.##.#.##.#.##.#.##.#.##.#..##..##.
.............#.#..#######.########################........#.........##....................##..#....................................##..##..
.............#.#..#...............#..............#.......##..........##..................##..#######################################..##...
.............#.#..#..............................#.....#..............##................##...........................................##....
.............#.#..#...............#..............#....##...............##..............###############################################.....
.............#.#..#######..#######################..##..................##............##...................................................
.............#.#..#................................##....................##..........##....................................................
.............#.#..#...............................##......................##........##.....................................................
.............#.#..########################################################.##......##......................................................
.............#.#.........#.......#..........#........#.......#...#....#.....##....##.......................................................
.............#...............................................................##..##........................................................
.............#####################################################################.........................................................
