.........................................................#########....................................................................................................................................
.........................................................#.......#....................................................................................................................................
.....................................#####################.......#######################################################################################.............................................
.....................................#...........................#.....................................................................................##.............................................
.....................................#.....###............########......................................................................................##............................................
.....................................#.....###............#..............................................................................................##...........................................
..............................########.....###............#################...............................................................................##..........................................
..............................#...........................................##.......##.................................................#######################.........................................
..............................#.#########################################..##.....##........................................................................##........................................
..............................#.#...........................................##...##.....................................................###################..##.......................................
..............................#.#.############################################..##.....................................................##.................##..##....................................
..............................#.#.##########################################...##.....................................................##...................##..##.....................................
..............................#.#.............................................##.....................................................##........######.......##..##..................................
..............................#.###############################################.....................................................##........##.....##......##..##...................................
..............................#..........#.........................................................................................##........##.......##......##..##..................................
..............................##########.##.......................................................................................##........##.................##..##................................
.......................................##.##.................................................................................##..##..........#####..............##..##................................
........................................##.##...............................................................................##..##...............#...............##..##..............................
.........................................##.##.............................................................................##..##.................................##..##..............................
..........................................##.##...........................................................................##..####.#.##.#.##.#.##.#.##.#.##.#.##.#.##..##.............................
...........................................#.#...........................................................................##..##..#.##.#.##.#.##.#.##.#.##.#.##.#..##..##..............................
...........................................#.#..........................................................................##..#....................................##..##...............................
...........................................#.#.........................................................................##..#######################################..##................................
...........................................#.#........................................................................##...........................................##.................................
...........................................#.#.......................................................................###############################################..................................
...........................................#.#......................................................................##................................................................................
...........................................#.#.....................................................................##.................................................................................
...........................................#.#....................................................................##..................................................................................
...........................................#.#...................................................................##...................................................................................
...........................................#.#..................................................................##....................................................................................
...........................................#...................................................................##.....................................................................................
...........................................#####################################################################......................................................................................
......................................................................................................................................................................................................
......................................................................................................................................................................................................
......................................................................................................................................................................................................
......................................................................................................................................................................................................
......................................................................................................................................................................................................
......................................................................................................................................................................................................
......................................................................................................................................................................................................
......................................................................................................................................................................................................
......................................................................................................................................................................................................
......................................................................................................................................................................................................
......................................................................................................................................................................................................
......................................................................................................................................................................................................
......................................................................................................................................................................................................
......................................................................................................................................................................................................
......................................................................................................................................................................................................
......................................................................................................................................................................................................
......................................................................................................................................................................................................
......................................................................................................................................................................................................
......................................................................................................................................................................................................
......................................................................................................................................................................................................
......................................................................................................................................................................................................
......................................................................................................................................................................................................
......................................................................................................................................................................................................
......................................................................................................................................................................................................
......................................................................................................................................................................................................
......................................................................................................................................................................................................
......................................................................................................................................................................................................
......................................................................................................................................................................................................