.........................................................#########....................................................................................................................................
.........................................................#.......#....................................................................................................................................
.....................................#####################.......#######################################################################################.............................................
.....................................#...........................#.....................................................................................##.............................................
.....................................#.....###............########......................................................................................##............................................
.....................................#.....###............#...........................................#######################............................##...........................................
..............................########.....###............#################..................................#..............##............................##..........................................
..............................#...........................................##.......##...................####..#..............################################.........................................
..............................#.#########################################..##.....##...................#....#..#............................................##........................................
..............................#.#...........................................##...##...................#.....#...#.......................###################..##.......................................
..............................#.#.############################################..##....................#.#...#..#.......................##.................##..##....................................
..............................#.#.##########################################...##.....................#..##...#.......................##...................##..##.....................................
..............................#.#.............................................##.....................###.....#.......................##........######.......##..##..................................
..............................#.###############################################.....................##..######......................##........##.....##......##..##...................................
..............................#..........#.........................................................##..............................##........##.......##......##..##..................................
..............................##########.##.....################################..................##..............................##........##.................##..##................................
.......................................##.##....#...............#..............#........###########..........................##..##..........#####..............##..##................................
........................................##.##...#..............#...............#........###########.........................##..##...............#...............##..##..............................
.........................................##.##..#.............#................#........###########........................##..##.................................##..##..............................
..........................................##.##.#............#.................#........###########.......................##..####.#.##.#.##.#.##.#.##.#.##.#.##.#.##..##.............................
...........................................#.#..#...........#..................#........###########......................##..##..#.##.#.##.#.##.#.##.#.##.#.##.#..##..##..............................
...........................................#.#..#######.########################........#.........##....................##..#....................................##..##...............................
...........................................#.#..#...............#..............#.......##..........##..................##..#######################################..##................................
...........................................#.#..#..............................#.....#..............##................##...........................................##.................................
...........................................#.#..#...............#..............#....##...............##..............###############################################..................................
...........................................#.#..#######..#######################..##..................##............##................................................................................
...........................................#.#..#................................##....................##..........##.................................................................................
...........................................#.#..#...............................##......................##........##..................................................................................
...........................................#.#..########################################################.##......##...................................................................................
...........................................#.#.........#.......#..........#........#.......#...#....#.....##....##....................................................................................
...........................................#...............................................................##..##.....................................................................................
...........................................#####################################################################......................................................................................
......................................................................................................................................................................................................
......................................................................................................................................................................................................
......................................................................................................................................................................................................
......................................................................................................................................................................................................
......................................................................................................................................................................................................
......................................................................................................................................................................................................
......................................................................................................................................................................................................
......................................................................................................................................................................................................
......................................................................................................................................................................................................
......................................................................................................................................................................................................
......................................................................................................................................................................................................
......................................................................................................................................................................................................
......................................................................................................................................................................................................
......................................................................................................................................................................................................
......................................................................................................................................................................................................
......................................................................................................................................................................................................
......................................................................................................................................................................................................
......................................................................................................................................................................................................
......................................................................................................................................................................................................
......................................................................................................................................................................................................
......................................................................................................................................................................................................
......................................................................................................................................................................................................
......................................................................................................................................................................................................
......................................................................................................................................................................................................
......................................................................................................................................................................................................
......................................................................................................................................................................................................
......................................................................................................................................................................................................
......................................................................................................................................................................................................